


                       MOVE : ↑,↓,→,← | RESET : R
                                                         
           ######################################          #############
           #                                    #          #           #
           #                                    ############           #
           #      ##############                                       #
           #      #             #                                      #
           #      # ##########  #                                      #
           #      # #        #  #               ####   #####           #
           #      # #        #  #               #  #       #           #
           #      # #        #  #               #  #########           #
           #      # #        #  ########   ######          #           # 
           #      # #        #         #   #               #           #
           #      # #        #    ######   ######          #           #
           #      # #        #    #             #          #           #
           #      # #        #     #           #           #           #
           #      ###        #      #         #            #           #         
           #                 #     #           #           #############
           #                 #    #             #
           ###################    ###############             
