







                                   
                               ######    ####     ####    ##      
                               ##       ##  ##     ##     ##      
                               ####     ######     ##     ##      
                               ##       ##  ##     ##     ##      
                               ##       ##  ##    ####    ######  
                                    
                                    
